空空空空空空空空空空空空空
空砖空砖空砖空砖空砖空砖空
空砖空砖空砖空砖空砖空砖空
空铁空砖空铁空砖空铁空砖空
空砖空砖空砖空砖空砖空砖空
空草空草空砖空草空草空砖空
空砖空砖空砖空砖空砖空砖空
空空空空空空空空空空空空空
空空空水水水水水水水空空空
空空空空空空空空空空空空空
空空空空空空空空空空空空空
空空空空空空空空空空空空空
空空空空空空空空空空空空空